Date,Description,Value,Balance
07/08/2016,8389 proper tie,-20,-Â£212.47
08/08/2016,8670 best idea,-106.56,-319.03
08/08/2016,6267 negative rich,-898.62,-1217.65
08/08/2016,7572 worth goal,-200,-1417.65
08/08/2016,3781 western pension,-30,-1447.65
08/08/2016,7991 enough land,-2.18,-1449.83
08/08/2016,7668 federal increase,-120,-1569.83
08/08/2016,2251 capable temporary,-60,-1629.83
09/08/2016,3540 top development,-15.12,-1644.95
09/08/2016,5292 capable temporary,-10,-1654.95
10/08/2016,2949 female instance,-460,-2114.95
11/08/2016,5257 sudden whole,0.24,-2114.71
11/08/2016,390 sudden whole,0.35,-2114.36
12/08/2016,2570 sick garbage,-2.6,-2116.96
12/08/2016,9004 crazy entrance,-39.97,-2156.93
12/08/2016,8597 close inspection,1726.28,-430.65
15/08/2016,6827 best idea,-28.38,-459.03
15/08/2016,1975 negative rich,-132.07,-591.1
15/08/2016,7085 green recommendation,-30,-621.1
15/08/2016,827 ready pride,-43.6,-664.7
15/08/2016,8895 straight bus,-8.54,-673.24
15/08/2016,7434 crazy car,-20,-693.24
16/08/2016,176 additional cook,-59.35,-752.59
16/08/2016,1348 leading poem,-40,-792.59
16/08/2016,467 royal resource,-10,-802.59
17/08/2016,3266 western pension,-60,-862.59
17/08/2016,1943 western pension,-60,-922.59
18/08/2016,2750 western pension,-70,-992.59
18/08/2016,8574 smooth inspection,-50,-1042.59
18/08/2016,1823 western pension,-60,-1102.59
19/08/2016,8000 straight bus,-3.39,-1105.98
19/08/2016,4239 minor shake,-57.26,-1163.24
19/08/2016,1360 female instance,-20,-1183.24
19/08/2016,3008 sufficient science,-157,-1340.24
22/08/2016,6716 western pension,-20,-1360.24
22/08/2016,8860 leading poem,-160,-1520.24
22/08/2016,6917 sufficient science,-18.62,-1538.86
22/08/2016,6764 capable temporary,-40,-1578.86
22/08/2016,6195 close inspection,504.34,-1074.52
23/08/2016,4482 nasty interview,-92.05,-1166.57
24/08/2016,1516 western pension,-10,-1176.57
26/08/2016,4288 royal resource,-10,-1186.57
26/08/2016,989 worth goal,-70,-1256.57
30/08/2016,4992 close inspection,1756.01,499.44
30/08/2016,8369 sufficient science,-32.55,466.89
30/08/2016,8021 full dust,0.03,466.92
30/08/2016,1837 straight bus,-2.5,464.42
30/08/2016,6968 rough post,-70,394.42
30/08/2016,8631 best idea,-59.9,334.52
30/08/2016,9029 sufficient science,-56.13,278.39
30/08/2016,8043 female instance,-80,198.39
30/08/2016,1601 main train,-5.85,192.54
01/09/2016,4003 main train,-74.01,118.53
01/09/2016,5898 previous familiar,38.31,156.84
01/09/2016,9909 sufficient science,-23.25,133.59
01/09/2016,1812 sufficient science,-31.05,102.54
01/09/2016,6504 capable temporary,-40,62.54
01/09/2016,4296 calm double,-40,22.54
01/09/2016,8184 initial project,-22.07,0.470000000000034
01/09/2016,4430 straight bus,-8.52,-8.04999999999997
02/09/2016,1413 grand teaching,-49.33,-57.38
02/09/2016,8521 sufficient science,-33.29,-90.67
02/09/2016,2645 nearby reading,-130,-220.67
05/09/2016,3452 sufficient science,-26.91,-247.58
05/09/2016,4465 adult stage,-1760,-2007.58
05/09/2016,981 negative rich,-80.21,-2087.79
05/09/2016,1473 money show,-12.41,-2100.2
05/09/2016,902 capable temporary,-70,-2170.2
05/09/2016,5583 resident pop,-17.96,-2188.16
06/09/2016,6848 separate wood,-22.22,-2210.38
06/09/2016,9531 able habit,-70,-2280.38
06/09/2016,5377 grand teaching,-72.95,-2353.33
07/09/2016,2100 nearby reading,-60,-2413.33
07/09/2016,4575 western pension,-50,-2463.33
07/09/2016,3773 sufficient science,-38.99,-2502.32
07/09/2016,6608 crazy car,-70,-2572.32
07/09/2016,6499 money show,-30.27,-2602.59
08/09/2016,8132 straight bus,-42.22,-2644.81
09/09/2016,1166 such cost,-14.53,-2659.34
09/09/2016,8810 money show,-92.48,-2751.82
09/09/2016,4229 capable temporary,-60,-2811.82
12/09/2016,2534 close inspection,633.53,-2178.29
12/09/2016,2119 complex cook,-12.93,-2191.22
12/09/2016,6004 normal distribution,-6.52,-2197.74
12/09/2016,3264 female instance,-50,-2247.74
12/09/2016,7173 main train,-2.09,-2249.83
12/09/2016,7590 main train,-27.01,-2276.84
12/09/2016,9904 negative rich,-48.61,-2325.45
12/09/2016,7129 tough advertising,-31.2,-2356.65
13/09/2016,1497 solid check,-10,-2366.65
14/09/2016,7093 quiet organization,-96.93,-2463.58
14/09/2016,758 daughter double,-135.33,-2598.91
15/09/2016,1591 dead focus,-61.04,-2659.95
16/09/2016,8470 money show,-14.14,-2674.09
16/09/2016,9870 female instance,-10,-2684.09
19/09/2016,9241 best idea,-50.2,-2734.29
19/09/2016,6538 close inspection,4256.41,1522.12
19/09/2016,5761 complex cook,-36.87,1485.25
19/09/2016,6295 female instance,-80,1405.25
20/09/2016,7112 west physical,-20,1385.25
20/09/2016,9226 western pension,-20,1365.25
21/09/2016,2376 full dust,0.03,1365.28
21/09/2016,7540 typical wall,-5.69,1359.59
21/09/2016,5688 complex cook,-67.65,1291.94
21/09/2016,6761 grand teaching,-29.72,1262.22
22/09/2016,9850 wonderful sister,-80,1182.22
22/09/2016,5298 simple stop,-55.93,1126.29
22/09/2016,621 straight bus,-28.69,1097.6
23/09/2016,8440 human society,-340,757.600000000001
23/09/2016,9014 living nobody,-55.73,701.870000000001
23/09/2016,683 specialist sound,-8.62,693.250000000001
26/09/2016,4447 sufficient science,-193.9,499.350000000001
26/09/2016,1001 female instance,-70,429.350000000001
26/09/2016,3541 short warning,-30,399.350000000001
26/09/2016,4589 money show,-15,384.350000000001
26/09/2016,5519 specialist sound,-52.65,331.700000000001
26/09/2016,4460 complex cook,-28.99,302.710000000001
26/09/2016,8960 important period,-111.51,191.200000000001
28/09/2016,7708 western pension,-20,171.200000000001
30/09/2016,8607 fat nose,-4.33,166.870000000001
30/09/2016,3467 western pension,-30,136.870000000001
30/09/2016,3804 solid check,-180,-43.1299999999989
30/09/2016,1633 efficient outside,-121.48,-164.609999999999
03/10/2016,8285 main train,-13.95,-178.559999999999
03/10/2016,7901 main train,-25.27,-203.829999999999
03/10/2016,8358 choice force,-12.54,-216.369999999999
03/10/2016,2338 sufficient science,-36.71,-253.079999999999
03/10/2016,2539 able habit,-10,-263.079999999999
03/10/2016,1656 western pension,-40,-303.079999999999
03/10/2016,6044 existing jump,-11.84,-314.919999999999
03/10/2016,1547 honest inside,-8.5,-323.419999999999
03/10/2016,2531 straight bus,-7.74,-331.159999999999
03/10/2016,2548 specialist sound,-93.25,-424.409999999999
03/10/2016,5779 agent review,-40,-464.409999999999
03/10/2016,2764 fat nose,-12.99,-477.399999999999
04/10/2016,6586 capable temporary,-50,-527.399999999999
04/10/2016,1432 training library,-20.11,-547.509999999999
04/10/2016,487 close inspection,983.78,436.270000000001
04/10/2016,1042 nearby reading,-60,376.270000000001
04/10/2016,8799 best idea,-98.48,277.790000000001
05/10/2016,8427 human society,-2000,-1722.21
06/10/2016,723 decent sugar,-41.41,-1763.62
10/10/2016,8790 capable temporary,-20,-1783.62
10/10/2016,127 money show,-170.03,-1953.65
10/10/2016,805 capable temporary,-60,-2013.65
10/10/2016,1739 upset examination,-310.2,-2323.85
10/10/2016,2224 sufficient science,-29.9,-2353.75
10/10/2016,2692 sufficient science,-82.34,-2436.09
12/10/2016,6558 sufficient science,-57.12,-2493.21
12/10/2016,1882 money show,-31.99,-2525.2
12/10/2016,6036 western pension,-20,-2545.2
12/10/2016,6171 grand teaching,-25.46,-2570.66
13/10/2016,3213 typical wall,-10.4,-2581.06
14/10/2016,9714 severe independent,-50.22,-2631.28
14/10/2016,2677 straight bus,-12.74,-2644.02
17/10/2016,9070 illegal water,-64.6,-2708.62
17/10/2016,6044 agent ideal,-20,-2728.62
17/10/2016,9762 friendly marketing,-60,-2788.62
17/10/2016,4312 female instance,-40,-2828.62
17/10/2016,7544 sufficient science,-134.28,-2962.9
17/10/2016,9902 western pension,-20,-2982.9
18/10/2016,7174 complex cook,-63.52,-3046.42
18/10/2016,9299 money show,-37.67,-3084.09
18/10/2016,9193 capable temporary,-30,-3114.09
18/10/2016,3127 solid check,-90,-3204.09
19/10/2016,1912 close inspection,422.16,-2781.93
19/10/2016,8834 enough land,-17.08,-2799.01
19/10/2016,3908 friendly marketing,-40,-2839.01
19/10/2016,4920 friendly marketing,-40,-2879.01
20/10/2016,9135 main train,-4.27,-2883.28
20/10/2016,8618 money show,-80.13,-2963.41
20/10/2016,4840 brief development,-24.62,-2988.03
21/10/2016,6190 nearby reading,-40,-3028.03
21/10/2016,8623 able habit,-30,-3058.03
21/10/2016,5109 enough land,-10.48,-3068.51
21/10/2016,3672 western pension,-20,-3088.51
21/10/2016,8373 sufficient science,-744.19,-3832.7
21/10/2016,3140 capable temporary,-10,-3842.7
24/10/2016,3644 past produce,-31.27,-3873.97
24/10/2016,3878 close inspection,2179.63,-1694.34
24/10/2016,9592 nearby reading,-60,-1754.34
24/10/2016,2753 solid check,-60,-1814.34
24/10/2016,3862 true fan,-30,-1844.34
24/10/2016,2929 grand teaching,-14.73,-1859.07
24/10/2016,9281 best idea,-131.68,-1990.75
25/10/2016,2085 full dust,0.03,-1990.72
25/10/2016,5645 used river,-13.09,-2003.81
26/10/2016,8161 money show,-68.2,-2072.01
27/10/2016,7893 sufficient science,-6.97,-2078.98
27/10/2016,7661 friendly mistake,-19.01,-2097.99
27/10/2016,1796 western pension,-100,-2197.99
28/10/2016,702 still laugh,-80.19,-2278.18
31/10/2016,5879 main train,-24.62,-2302.8
31/10/2016,3256 both end,-24.01,-2326.81
31/10/2016,4788 nearby reading,-190,-2516.81
31/10/2016,2666 worth goal,-100,-2616.81
31/10/2016,4668 human society,-620,-3236.81
01/11/2016,5874 money show,-28.9,-3265.71
01/11/2016,5400 western pension,-20,-3285.71
01/11/2016,5921 close inspection,248.81,-3036.9
01/11/2016,3310 enough land,-15.66,-3052.56
02/11/2016,1558 short warning,-40.08,-3092.64
02/11/2016,4154 weak vacation,-70,-3162.64
02/11/2016,8443 solid check,-30,-3192.64
02/11/2016,6208 money show,-42.65,-3235.29
02/11/2016,4239 money show,-32.96,-3268.25
02/11/2016,6652 western pension,-30,-3298.25
03/11/2016,4766 sufficient science,-65.64,-3363.89
04/11/2016,5948 friendly marketing,-110,-3473.89
07/11/2016,8 money show,-73.51,-3547.4
07/11/2016,6167 short warning,-104.58,-3651.98
07/11/2016,9914 main train,-7.69,-3659.67
07/11/2016,5694 close inspection,4548.34,888.670000000001
07/11/2016,2129 money show,-35.07,853.600000000001
07/11/2016,436 best idea,-111.1,742.500000000001
07/11/2016,9590 full dust,0.04,742.540000000001
08/11/2016,367 western pension,-20,722.540000000001
09/11/2016,9341 used river,-113.78,608.760000000001
11/11/2016,1951 warm task,-31.07,577.690000000001
11/11/2016,1923 money show,-17.57,560.120000000001
14/11/2016,7746 money show,-55.19,504.930000000001
14/11/2016,8135 female instance,-30,474.930000000001
14/11/2016,4880 capable temporary,-40,434.930000000001
14/11/2016,2396 still laugh,-30.1,404.830000000001
14/11/2016,1460 pregnant wall,-1.33,403.500000000001
14/11/2016,7715 able habit,-40,363.500000000001
15/11/2016,9759 sufficient science,-50.11,313.390000000001
16/11/2016,6857 sufficient science,-61.87,251.520000000001
16/11/2016,3024 sufficient science,-4.47,247.050000000001
18/11/2016,7237 western pension,-50,197.050000000001
21/11/2016,34 super conclusion,3.75,200.800000000001
21/11/2016,3591 negative rich,-282.75,-81.9499999999992
22/11/2016,8540 human society,-2360,-2441.95
22/11/2016,2530 money show,-8.59,-2450.54
24/11/2016,2279 grand teaching,-6.04,-2456.58
25/11/2016,6651 grand teaching,-46.26,-2502.84
28/11/2016,291 wonderful sister,-50,-2552.84
28/11/2016,5029 rough post,-60,-2612.84
28/11/2016,7573 grand teaching,-39.94,-2652.78
28/11/2016,1804 normal distribution,-12.79,-2665.57
28/11/2016,2686 confident situation,-59.34,-2724.91
28/11/2016,217 capable temporary,-50,-2774.91
29/11/2016,4025 sufficient science,-40,-2814.91
30/11/2016,6998 money show,-34.28,-2849.19
30/11/2016,9690 female instance,-30,-2879.19
30/11/2016,5261 close inspection,91.47,-2787.72
30/11/2016,8086 rough leather,-81.06,-2868.78
01/12/2016,1430 money show,-26.06,-2894.84
01/12/2016,4592 solid check,-120,-3014.84
01/12/2016,4252 complex cook,-53.07,-3067.91
01/12/2016,7442 sufficient science,-138.75,-3206.66
01/12/2016,5431 sufficient science,-121.89,-3328.55
01/12/2016,5895 most place,-60,-3388.55
02/12/2016,4610 wonderful beyond,-54.33,-3442.88
02/12/2016,8962 wonderful beyond,-91.01,-3533.89
02/12/2016,2510 money show,-101.52,-3635.41
05/12/2016,4729 effective sentence,-122.99,-3758.4
05/12/2016,5036 money show,-9.45,-3767.85
05/12/2016,1581 western pension,-20,-3787.85
05/12/2016,2271 best idea,-157.38,-3945.23
05/12/2016,7066 close inspection,1784.67,-2160.56
06/12/2016,9692 western pension,-40,-2200.56
06/12/2016,8168 full dust,0.05,-2200.51
07/12/2016,8971 chemical base,-41.36,-2241.87
07/12/2016,451 money show,-48.79,-2290.66
07/12/2016,9175 western pension,-20,-2310.66
07/12/2016,8234 used river,-42.24,-2352.9
09/12/2016,9757 smooth inspection,-10,-2362.9
09/12/2016,6710 choice stress,-7.65,-2370.55
09/12/2016,4217 work dress,-20.49,-2391.04
12/12/2016,4573 work dress,-23.54,-2414.58
12/12/2016,3659 money show,-6.45,-2421.03
12/12/2016,3748 crazy car,-30,-2451.03
13/12/2016,231 western pension,-10,-2461.03
13/12/2016,4419 rough post,-40,-2501.03
13/12/2016,2175 human society,-1050,-3551.03
14/12/2016,1121 negative rich,-30.4,-3581.43
15/12/2016,3276 few resist,-60,-3641.43
15/12/2016,7149 work dress,-7.17,-3648.6
15/12/2016,9233 capable temporary,-150,-3798.6
16/12/2016,8553 complex cook,-142.71,-3941.31
16/12/2016,9545 enough earth,-2.47,-3943.78
16/12/2016,9851 scared mouth,-5.65,-3949.43
16/12/2016,325 western pension,-30,-3979.43
19/12/2016,9289 money show,-19.33,-3998.76
19/12/2016,6576 capable temporary,-10,-4008.76
19/12/2016,3042 female instance,-20,-4028.76
19/12/2016,3787 royal error,750,-3278.76
19/12/2016,9694 big damage,-64.67,-3343.43
19/12/2016,4516 western pension,-420,-3763.43
20/12/2016,3406 western pension,-30,-3793.43
20/12/2016,4371 junior river,-40,-3833.43
22/12/2016,4219 impossible feeling,-10.13,-3843.56
22/12/2016,8843 normal distribution,-6.29,-3849.85
22/12/2016,6090 resident customer,-170.82,-4020.67
22/12/2016,362 junior river,-16.27,-4036.94
28/12/2016,3758 able habit,-60,-4096.94
28/12/2016,6266 ill quit,-5.03,-4101.97
28/12/2016,2591 trick native,-58.44,-4160.41
28/12/2016,9506 worth goal,-90,-4250.41
28/12/2016,9379 western pension,-40,-4290.41
28/12/2016,2035 solid check,-10,-4300.41
28/12/2016,3801 which mess,140.5,-4159.91
28/12/2016,2391 latter swing,740,-3419.91
29/12/2016,4125 negative rich,-81.36,-3501.27
29/12/2016,6267 think drunk,-91.82,-3593.09
29/12/2016,7531 western pension,-20,-3613.09
30/12/2016,4725 money show,-28.41,-3641.5
30/12/2016,242 close inspection,867.83,-2773.67
30/12/2016,9560 best idea,-110.39,-2884.06
03/01/2017,5444 all shoot,0.02,-2884.04
03/01/2017,7239 human society,-2290,-5174.04
03/01/2017,4752 used river,-53.08,-5227.12
03/01/2017,3875 narrow industry,75.79,-5151.33
03/01/2017,1126 narrow industry,50,-5101.33
03/01/2017,5084 money assist,-50,-5151.33
03/01/2017,2671 money assist,-30,-5181.33
03/01/2017,518 negative rich,-180,-5361.33
03/01/2017,1252 careful image,-40,-5401.33
03/01/2017,2733 several user,-40.63,-5441.96
03/01/2017,9061 international mobile,-60,-5501.96
03/01/2017,2754 clear grandfather,-63,-5564.96
04/01/2017,1245 cultural tie,-330.37,-5895.33
04/01/2017,8476 previous desire,-135.77,-6031.1
05/01/2017,2587 several user,-55.24,-6086.34
05/01/2017,3624 complex nurse,-50,-6136.34
05/01/2017,2020 negative rich,-123.2,-6259.54
05/01/2017,8224 wooden pop,-20,-6279.54
05/01/2017,9233 brilliant fishing,-30,-6309.54
05/01/2017,4082 some sea,-70,-6379.54
05/01/2017,2294 home vegetable,-40,-6419.54
05/01/2017,6186 several user,-26.16,-6445.7
06/01/2017,5547 wooden pop,-70,-6515.7
06/01/2017,4432 brilliant fishing,-50,-6565.7
06/01/2017,7587 such program,-20,-6585.7
09/01/2017,9923 careful image,-50,-6635.7
09/01/2017,4146 close inspection,2587.95,-4047.75
09/01/2017,1981 several user,-11.11,-4058.86
09/01/2017,7926 best idea,-104.22,-4163.08
09/01/2017,5853 close inspection,293.89,-3869.19
10/01/2017,9079 western pension,-70,-3939.19
10/01/2017,7813 money show,-23.99,-3963.18
10/01/2017,1909 western pension,-10,-3973.18
11/01/2017,6157 used river,-107.1,-4080.28
11/01/2017,7230 money show,-30.11,-4110.39
12/01/2017,4280 western pension,-20,-4130.39
12/01/2017,2211 middle fault,-26,-4156.39
12/01/2017,3202 capable temporary,-50,-4206.39
13/01/2017,1660 specialist sound,-46.19,-4252.58
16/01/2017,5378 western pension,-10,-4262.58
16/01/2017,310 solid check,-50,-4312.58
16/01/2017,2398 human society,-1400,-5712.58
16/01/2017,8166 capable temporary,-70,-5782.58
16/01/2017,7504 sufficient science,-68.5,-5851.08
17/01/2017,7524 either program,-3.46,-5854.54
17/01/2017,8234 comprehensive green,-40.55,-5895.09
17/01/2017,1110 most maximum,-20,-5915.09
18/01/2017,1219 money show,-14.62,-5929.71
19/01/2017,3994 western pension,-30,-5959.71
20/01/2017,4167 western pension,-40,-5999.71
20/01/2017,6496 sufficient science,-9.48,-6009.19
23/01/2017,7084 crazy car,-40,-6049.19
23/01/2017,7122 enough land,-6.01,-6055.2
23/01/2017,5458 training library,-12.08,-6067.28
23/01/2017,3365 western pension,-30,-6097.28
23/01/2017,7360 close inspection,12.36,-6084.92
23/01/2017,8724 able habit,-30,-6114.92
23/01/2017,2049 money show,-56.5,-6171.42
24/01/2017,3654 friendly mistake,-10.22,-6181.64
24/01/2017,5843 female instance,-20,-6201.64
24/01/2017,7024 friendly marketing,-110,-6311.64
24/01/2017,960 money show,-25.69,-6337.33
25/01/2017,7286 money show,-26.22,-6363.55
25/01/2017,7063 female instance,-80,-6443.55
25/01/2017,4471 western pension,-110,-6553.55
26/01/2017,3827 close inspection,2301.07,-4252.48
27/01/2017,3932 best idea,-19.94,-4272.42
30/01/2017,4263 full dust,0.02,-4272.4
30/01/2017,3777 able habit,-20,-4292.4
30/01/2017,7840 money show,-30.22,-4322.62
30/01/2017,7062 sufficient science,-42.19,-4364.81
30/01/2017,1518 sufficient science,-16.94,-4381.75
30/01/2017,2426 western pension,-60,-4441.75
30/01/2017,3684 used river,-39.74,-4481.49
30/01/2017,1931 sufficient science,-35.49,-4516.98
30/01/2017,3980 enough land,-7.74,-4524.72
30/01/2017,7345 living nobody,-63.43,-4588.15
30/01/2017,4927 rare technology,-38.5,-4626.65
30/01/2017,9913 capable temporary,-30,-4656.65
30/01/2017,6456 close inspection,141.42,-4515.23
30/01/2017,2284 human society,-2000,-6515.23
31/01/2017,1070 logical count,-21.99,-6537.22
31/01/2017,504 money show,-37.74,-6574.96
31/01/2017,4294 brief development,-15.26,-6590.22
31/01/2017,7174 foreign week,-32.27,-6622.49
01/02/2017,5277 agent review,-10,-6632.49
01/02/2017,1036 sufficient science,-53.5,-6685.99
01/02/2017,346 most place,-30,-6715.99
01/02/2017,9537 sufficient science,-12.2,-6728.19
02/02/2017,8061 money show,-14.84,-6743.03
02/02/2017,3314 capable temporary,-60,-6803.03
03/02/2017,367 comprehensive green,-40,-6843.03
03/02/2017,1609 latter swing,270,-6573.03
03/02/2017,7877 comprehensive green,-118.9,-6691.93
03/02/2017,1913 short warning,-106.03,-6797.96
06/02/2017,3182 friendly mistake,-10.35,-6808.31
06/02/2017,4467 fit database,-165.67,-6973.98
06/02/2017,3415 enough land,-14.03,-6988.01
06/02/2017,4649 western pension,-20,-7008.01
06/02/2017,7119 enough land,-19.46,-7027.47
06/02/2017,2683 female instance,-140,-7167.47
07/02/2017,9869 latter swing,10,-7157.47
07/02/2017,3094 head body,-99.56,-7257.03
08/02/2017,8230 choice beautiful,-70,-7327.03
08/02/2017,3908 smart purple,-46.88,-7373.91
08/02/2017,9844 work dress,-25.9,-7399.81
08/02/2017,2959 electrical lack,-75.83,-7475.64
09/02/2017,1191 money show,-31.02,-7506.66
09/02/2017,3371 choice stress,-114.2,-7620.86
09/02/2017,2240 latter swing,80,-7540.86
10/02/2017,3750 close inspection,4543.56,-2997.3
10/02/2017,1032 comprehensive green,-37.73,-3035.03
13/02/2017,8743 best idea,-143.61,-3178.64
13/02/2017,2151 close inspection,42.53,-3136.11
13/02/2017,6250 slow life,-3.4,-3139.51
13/02/2017,3799 human society,-1380,-4519.51
13/02/2017,6921 money show,-61.39,-4580.9
13/02/2017,3073 private clock,-25.79,-4606.69
13/02/2017,9523 solid check,-40,-4646.69
14/02/2017,1587 used river,-45.02,-4691.71
14/02/2017,9064 private clock,-30.48,-4722.19
14/02/2017,3800 adult champion,-29.6,-4751.79
15/02/2017,3989 western pension,-40,-4791.79
15/02/2017,826 federal increase,-30,-4821.79
15/02/2017,7237 money show,-42.07,-4863.86
16/02/2017,1956 private clock,-12.97,-4876.83
16/02/2017,2187 money show,-82.38,-4959.21
16/02/2017,3277 worth goal,-120,-5079.21
17/02/2017,4549 money show,-16.54,-5095.75
17/02/2017,7445 western pension,-10,-5105.75
20/02/2017,6433 money show,-6.46,-5112.21
20/02/2017,5492 solid check,-80,-5192.21
20/02/2017,7028 neat suggestion,-70,-5262.21
20/02/2017,7439 work working,-20,-5282.21
20/02/2017,4841 western pension,-40,-5322.21
20/02/2017,8024 complex cook,-12,-5334.21
20/02/2017,1745 legal young,-15.11,-5349.32
21/02/2017,1325 upper climate,-18.6,-5367.92
21/02/2017,8331 total guitar,-40,-5407.92
21/02/2017,5046 money show,-24.07,-5431.99
22/02/2017,2384 complex cook,-57.15,-5489.14
22/02/2017,9984 worth goal,-40,-5529.14
22/02/2017,5236 best idea,-34.39,-5563.53
22/02/2017,1353 close inspection,4257.87,-1305.66
23/02/2017,8450 full dust,0.03,-1305.63
23/02/2017,973 negative rich,-394.92,-1700.55
23/02/2017,5994 human society,-720,-2420.55
24/02/2017,7979 money show,-40.54,-2461.09
27/02/2017,9747 money show,-63.96,-2525.05
27/02/2017,8693 used river,-80.97,-2606.02
27/02/2017,5268 money show,-78.41,-2684.43
27/02/2017,6149 western pension,-100,-2784.43
27/02/2017,8897 main train,-9.4,-2793.83
27/02/2017,3984 administrative seat,-40,-2833.83
27/02/2017,8106 latter swing,130,-2703.83
28/02/2017,2167 raw dish,-66.08,-2769.91
28/02/2017,9943 raw dish,-56.55,-2826.46
28/02/2017,878 friendly mistake,-3.75,-2830.21
28/02/2017,7022 friendly marketing,-60,-2890.21
28/02/2017,1494 money show,-26.22,-2916.43
01/03/2017,7550 calm run,-18.32,-2934.75
01/03/2017,4996 spare dust,-28.99,-2963.74
01/03/2017,9954 western pension,-30,-2993.74
01/03/2017,5859 western pension,-190,-3183.74
01/03/2017,4884 latter god,-18.29,-3202.03
02/03/2017,2122 money show,-54.3,-3256.33
02/03/2017,1367 able habit,-7.69,-3264.02
02/03/2017,6475 able habit,-40,-3304.02
02/03/2017,4679 western pension,-110,-3414.02
02/03/2017,3929 crazy car,-100,-3514.02
02/03/2017,7630 money show,-37.8,-3551.82
02/03/2017,3649 southern city,-20.17,-3571.99
03/03/2017,3354 sufficient science,-298.64,-3870.63
03/03/2017,4024 money show,-46.94,-3917.57
03/03/2017,2868 crazy car,-20,-3937.57
03/03/2017,643 solid check,-50,-3987.57
03/03/2017,5705 money show,-10.55,-3998.12
03/03/2017,7294 white wife,-2.4,-4000.52
06/03/2017,9707 money show,-18.41,-4018.93
06/03/2017,2386 close inspection,1816.95,-2201.98
06/03/2017,8182 comprehensive green,-80,-2281.98
07/03/2017,2378 western pension,-30,-2311.98
07/03/2017,6843 human society,-860,-3171.98
07/03/2017,3703 true fan,-20,-3191.98
08/03/2017,6085 true fan,-30,-3221.98
08/03/2017,123 capable temporary,-200,-3421.98
08/03/2017,1648 best idea,-66.87,-3488.85
08/03/2017,6282 tight share,-14.44,-3503.29
08/03/2017,2861 western pension,-70,-3573.29
09/03/2017,1916 main train,-49.71,-3623
09/03/2017,4758 used river,-42.55,-3665.55
09/03/2017,3376 money show,-32.85,-3698.4
09/03/2017,1952 female instance,-190,-3888.4
10/03/2017,246 money show,-15.56,-3903.96
10/03/2017,1871 federal increase,-10,-3913.96
10/03/2017,2784 federal increase,-60,-3973.96
10/03/2017,797 female instance,-20,-3993.96
13/03/2017,4570 female instance,-110,-4103.96
13/03/2017,3377 money show,-38.55,-4142.51
13/03/2017,8027 money show,-31.67,-4174.18
13/03/2017,6701 square broad,-84.61,-4258.79
13/03/2017,3028 sufficient science,-42.75,-4301.54
13/03/2017,3615 solid check,-110,-4411.54
14/03/2017,3912 proper tie,-7.26,-4418.8
14/03/2017,3137 money show,-52.44,-4471.24
15/03/2017,3974 proper tie,-20,-4491.24
15/03/2017,9669 female instance,-110,-4601.24
16/03/2017,932 money show,-53.71,-4654.95
16/03/2017,2726 western pension,-190,-4844.95
16/03/2017,1100 close inspection,1316.09,-3528.86
16/03/2017,114 cute negative,-25.46,-3554.32
20/03/2017,3213 western pension,-50,-3604.32
20/03/2017,9846 cute negative,-14.79,-3619.11
20/03/2017,9177 choice stress,-60.21,-3679.32
20/03/2017,9019 separate hold,-130.59,-3809.91
20/03/2017,490 less click,-80,-3889.91
20/03/2017,6151 smart purple,-25.02,-3914.93
20/03/2017,6962 best idea,-39.37,-3954.3
20/03/2017,6994 cute negative,-42.01,-3996.31
21/03/2017,3111 main train,-51.97,-4048.28
21/03/2017,1634 used river,-110.53,-4158.81
22/03/2017,9298 key wave,-25.11,-4183.92
22/03/2017,6447 female instance,-100,-4283.92
22/03/2017,8447 cute negative,-47.36,-4331.28
22/03/2017,6832 solid check,-70,-4401.28
23/03/2017,8190 friendly marketing,-50,-4451.28
23/03/2017,5883 training library,-60.24,-4511.52
23/03/2017,3567 human society,-1630,-6141.52
24/03/2017,9024 negative rich,-101.36,-6242.88
24/03/2017,4861 cute negative,-4.69,-6247.57
24/03/2017,9907 extra point,-20,-6267.57
27/03/2017,9659 cute negative,-16.73,-6284.29999999999
27/03/2017,3580 close inspection,594.32,-5689.98
27/03/2017,7394 external wish,-18.86,-5708.84
27/03/2017,6214 cute negative,-29.77,-5738.61
27/03/2017,3978 nearby reading,-40,-5778.61
27/03/2017,9168 western pension,-150,-5928.61
27/03/2017,6691 sufficient science,-34.54,-5963.15
27/03/2017,6471 female instance,-40,-6003.15
27/03/2017,822 comprehensive green,-74.66,-6077.81
27/03/2017,9667 normal distribution,-19.25,-6097.05999999999
27/03/2017,7541 training library,-63.2,-6160.26
28/03/2017,4681 proper tie,-30,-6190.26
30/03/2017,1790 female instance,-40,-6230.26
30/03/2017,1021 cute negative,-25.75,-6256.00999999999
30/03/2017,347 female instance,-20,-6276.01
30/03/2017,2819 best idea,-29.26,-6305.27
30/03/2017,7542 close inspection,3855.04,-2450.22999999999
30/03/2017,5654 capable temporary,-70,-2520.22999999999
31/03/2017,2185 western pension,-40,-2560.22999999999
31/03/2017,7663 main train,-45.04,-2605.26999999999
31/03/2017,3815 complex cook,-14.55,-2619.82
31/03/2017,8682 red birthday,-265.49,-2885.31
31/03/2017,43 human society,-2200,-5085.31
31/03/2017,1373 complex cook,-47.73,-5133.04
31/03/2017,1396 scared glad,-6.86,-5139.89999999999
03/04/2017,427 western pension,-90,-5229.89999999999
03/04/2017,7668 used river,-19.93,-5249.83
03/04/2017,4565 cute negative,-30.49,-5280.31999999999
03/04/2017,2882 friendly mistake,-20,-5300.31999999999
03/04/2017,5671 present land,-80,-5380.31999999999
03/04/2017,5383 choice force,-9.09,-5389.40999999999
03/04/2017,4622 cute negative,-13.7,-5403.10999999999
03/04/2017,8520 cute negative,-27.73,-5430.83999999999
03/04/2017,6699 western pension,-160,-5590.83999999999
03/04/2017,5552 western pension,-50,-5640.83999999999
03/04/2017,6847 cute negative,-46.07,-5686.90999999999
03/04/2017,527 solid check,-60,-5746.90999999999
03/04/2017,9600 close inspection,117.27,-5629.63999999999
03/04/2017,7223 choice stress,-43.96,-5673.59999999999
03/04/2017,9155 complex cook,-11.93,-5685.52999999999
03/04/2017,9718 cute negative,-44.95,-5730.47999999999
03/04/2017,8850 cute negative,-15.38,-5745.85999999999
03/04/2017,1548 cute negative,-27.85,-5773.70999999999
03/04/2017,2099 poor feature,-13.67,-5787.37999999999
04/04/2017,1783 expensive seat,-4.08,-5791.45999999999
04/04/2017,990 friendly mistake,-21.68,-5813.13999999999
06/04/2017,7594 unique village,-28.64,-5841.77999999999
07/04/2017,8795 able habit,-20,-5861.77999999999
07/04/2017,5656 cute negative,-47.83,-5909.60999999999
10/04/2017,7924 western pension,-70,-5979.60999999999
10/04/2017,7266 cute negative,-53.03,-6032.63999999999
10/04/2017,9828 solid check,-140,-6172.63999999999
10/04/2017,5473 close inspection,2770.84,-3401.79999999999
10/04/2017,7077 human society,-2130,-5531.79999999999
10/04/2017,8462 cute negative,-4.31,-5536.10999999999
11/04/2017,8115 cute negative,-11.71,-5547.81999999999
11/04/2017,6732 best idea,-126.74,-5674.55999999999
11/04/2017,1176 cute negative,-16.58,-5691.13999999999
11/04/2017,7636 cute negative,-18.23,-5709.36999999999
11/04/2017,4299 cute negative,-42.71,-5752.07999999999
11/04/2017,1226 used river,-26.59,-5778.66999999999
11/04/2017,5567 cute negative,-21.38,-5800.04999999999
12/04/2017,4120 capable temporary,-130,-5930.04999999999
12/04/2017,2913 budget female,-7.64,-5937.68999999999
12/04/2017,8725 budget female,-8.81,-5946.49999999999
12/04/2017,1177 fair park,-6.42,-5952.91999999999
12/04/2017,6827 friendly mistake,-28.23,-5981.14999999999
13/04/2017,9957 true fan,-10,-5991.14999999999
13/04/2017,3499 his sad,-13.16,-6004.30999999999
13/04/2017,5119 unique village,-20,-6024.30999999999
18/04/2017,6227 nearby reading,-130,-6154.30999999999
18/04/2017,7810 solid check,-40,-6194.30999999999
18/04/2017,2315 cute negative,-22.11,-6216.41999999999
18/04/2017,1185 cute negative,-41.11,-6257.52999999999
18/04/2017,7164 western pension,-160,-6417.52999999999
18/04/2017,9226 main train,-80,-6497.52999999999
18/04/2017,8323 educational station,-15.2,-6512.72999999999
18/04/2017,8461 able habit,-57.72,-6570.44999999999
18/04/2017,5746 cute negative,-58.5,-6628.94999999999
18/04/2017,6461 unique village,-30,-6658.94999999999
18/04/2017,8615 cute negative,-35.68,-6694.62999999999
18/04/2017,2159 friendly mistake,-19.34,-6713.96999999999
18/04/2017,1305 capital silly,-20.57,-6734.53999999999
18/04/2017,9095 western pension,-40,-6774.53999999999
18/04/2017,1331 private clock,-38.9,-6813.43999999999
18/04/2017,6071 cute negative,-5.34,-6818.77999999999
18/04/2017,3506 federal increase,-30,-6848.77999999999
19/04/2017,4239 western pension,-90,-6938.77999999999
19/04/2017,831 cute negative,-29.02,-6967.79999999999
19/04/2017,2427 cute negative,-40.96,-7008.75999999999
19/04/2017,8084 western pension,-70,-7078.75999999999
20/04/2017,6224 cute negative,-77.77,-7156.53
20/04/2017,6700 western pension,-60,-7216.52999999999
20/04/2017,1148 past produce,-59.06,-7275.59
20/04/2017,6917 main train,-43.52,-7319.11
20/04/2017,8276 latter swing,750,-6569.11
21/04/2017,6212 close inspection,4356.69,-2212.42
21/04/2017,5452 cute negative,-6.3,-2218.72
21/04/2017,1526 solid check,-30,-2248.72
21/04/2017,3048 cute negative,-29.85,-2278.57
21/04/2017,9009 cute negative,-19.51,-2298.08
24/04/2017,2021 friendly marketing,-30,-2328.08
24/04/2017,5601 best idea,-53.15,-2381.23
24/04/2017,9242 short warning,-166.01,-2547.24
24/04/2017,3904 used river,-141.16,-2688.4
24/04/2017,583 extra female,-101.77,-2790.17
24/04/2017,4856 cute negative,-62.23,-2852.4
24/04/2017,2481 able habit,-30,-2882.4
25/04/2017,1292 western pension,-80,-2962.4
25/04/2017,1877 cute negative,-56.6,-3019
25/04/2017,1528 cute negative,-110.91,-3129.91
25/04/2017,7899 western pension,-100,-3229.91
26/04/2017,4241 cute negative,-10.64,-3240.55
26/04/2017,8246 cute negative,-67.23,-3307.78
26/04/2017,7622 cute negative,-42.42,-3350.2
26/04/2017,8172 human society,-2100,-5450.2
26/04/2017,5373 training library,-19.85,-5470.05
26/04/2017,7085 calm worth,-20,-5490.05
27/04/2017,9737 female instance,-20,-5510.05
27/04/2017,4997 cute negative,-48.25,-5558.3
28/04/2017,4628 solid check,-60,-5618.3
28/04/2017,1318 complex cook,-80,-5698.3
28/04/2017,765 cute negative,-22.62,-5720.92
28/04/2017,2257 main train,-11.12,-5732.04
28/04/2017,6450 female instance,-90,-5822.04
02/05/2017,4388 junior notice,26.7,-5795.34
02/05/2017,3778 cute negative,-36.92,-5832.26
02/05/2017,6013 friendly mistake,-12.9,-5845.16
02/05/2017,9152 cute negative,-17.92,-5863.08
02/05/2017,1216 female instance,-20,-5883.08
02/05/2017,4712 cute negative,-25.7,-5908.78
02/05/2017,346 nearby reading,-30,-5938.78
02/05/2017,9460 kind tree,3592.83,-2345.95
02/05/2017,9315 federal increase,-30,-2375.95
02/05/2017,8052 best idea,-97.83,-2473.78
02/05/2017,8477 human society,-310,-2783.78
02/05/2017,7882 cute negative,-2.23,-2786.01
02/05/2017,8934 red birthday,-101.5,-2887.51
02/05/2017,2683 federal increase,-20,-2907.51
02/05/2017,9343 cute negative,-83.9,-2991.41
02/05/2017,1257 unique village,-30,-3021.41
02/05/2017,6816 nearby reading,-60,-3081.40999999999
02/05/2017,7925 used river,-29.15,-3110.56
02/05/2017,2413 only spot,-31.38,-3141.94
02/05/2017,2815 extra point,-20,-3161.94
03/05/2017,3821 only spot,-54.81,-3216.75
03/05/2017,5251 western pension,-50,-3266.75
03/05/2017,7369 cute negative,-55.08,-3321.83
03/05/2017,7942 able habit,-33.09,-3354.92
04/05/2017,7896 friendly marketing,-10,-3364.92
04/05/2017,2781 exciting yesterday,-42.6,-3407.52
04/05/2017,3389 bitter shirt,-36.2,-3443.72
05/05/2017,2819 western pension,-80,-3523.71999999999
05/05/2017,2812 exciting yesterday,-102.26,-3625.98
05/05/2017,9405 intelligent hurry,-70,-3695.98
05/05/2017,3985 latter swing,160,-3535.98
05/05/2017,9267 female instance,-50,-3585.98
08/05/2017,2843 crazy car,-50,-3635.98
08/05/2017,2254 aware pension,-9.09,-3645.07
08/05/2017,3685 time chain,-50,-3695.07
08/05/2017,1726 large rich,-20,-3715.07
08/05/2017,2912 exciting yesterday,-11.64,-3726.71
08/05/2017,2234 exciting yesterday,-47.12,-3773.83
08/05/2017,5545 kind tree,3611.25,-162.579999999995
08/05/2017,9822 exciting yesterday,-14.08,-176.659999999995
08/05/2017,6130 best idea,-136.73,-313.389999999995
08/05/2017,6429 exciting yesterday,-19.27,-332.659999999995
08/05/2017,455 solid check,-10,-342.659999999995
08/05/2017,1112 solid check,-30,-372.659999999995
08/05/2017,6676 exciting yesterday,-30.53,-403.189999999995
08/05/2017,94 used river,-88.26,-491.449999999995
09/05/2017,6866 human society,-1150,-1641.45
09/05/2017,1937 neither cross,-9.47,-1650.92
09/05/2017,4153 western pension,-70,-1720.92
10/05/2017,5827 large rich,-20,-1740.92
10/05/2017,8022 exciting yesterday,-17.11,-1758.03
10/05/2017,9450 exciting yesterday,-22.61,-1780.64
10/05/2017,2525 exciting yesterday,-39.86,-1820.5
11/05/2017,3700 exciting yesterday,-7.64,-1828.14
11/05/2017,9939 exciting yesterday,-12.12,-1840.25999999999
11/05/2017,2623 intelligent hurry,-10,-1850.26
11/05/2017,5445 nearby reading,-150,-2000.25999999999
15/05/2017,1900 winter rub,-105.94,-2106.19999999999
15/05/2017,142 motor investment,-18.27,-2124.46999999999
15/05/2017,2381 exciting yesterday,-19.09,-2143.55999999999
15/05/2017,7785 motor investment,-6.13,-2149.69
15/05/2017,9281 motor investment,-6.5,-2156.19
15/05/2017,4311 motor investment,-9.44,-2165.63
15/05/2017,1223 female instance,-40,-2205.63
15/05/2017,2158 cheap hello,-30,-2235.63
15/05/2017,5352 exciting yesterday,-7.09,-2242.72
15/05/2017,6950 western pension,-170,-2412.72
15/05/2017,1537 impressive equal,-0.62,-2413.33999999999
15/05/2017,7190 latter swing,110,-2303.33999999999
16/05/2017,1168 exciting yesterday,-68.96,-2372.3
16/05/2017,7670 exciting yesterday,-9.89,-2382.19
16/05/2017,435 kind tree,4263.2,1881.01
17/05/2017,4966 exciting yesterday,-10.36,1870.65
17/05/2017,9377 crazy car,-20,1850.65
17/05/2017,7212 nearby reading,-120,1730.65000000001
18/05/2017,3314 best idea,-127.2,1603.45000000001
18/05/2017,1041 human society,-1310,293.450000000005
18/05/2017,6020 negative rich,-732.49,-439.039999999995
18/05/2017,2838 exciting yesterday,-9.76,-448.799999999995
18/05/2017,8949 brown park,-21.79,-470.589999999995
18/05/2017,2309 upstairs hope,-25.23,-495.819999999995
22/05/2017,1638 rich suggestion,-63.47,-559.289999999995
22/05/2017,4628 careful image,-70,-629.289999999995
22/05/2017,2473 used river,-74.9,-704.189999999995
22/05/2017,849 upstairs hope,-76.44,-780.629999999995
22/05/2017,1884 upstairs hope,-30.63,-811.259999999995
22/05/2017,9493 loud interest,-60,-871.259999999995
22/05/2017,1200 sorry birth,-4.88,-876.139999999995
22/05/2017,3267 upstairs hope,-19.8,-895.939999999995
22/05/2017,2054 upstairs hope,-2.42,-898.359999999995
22/05/2017,9339 careful image,-70,-968.359999999995
22/05/2017,614 upstairs hope,-6.67,-975.029999999995
22/05/2017,8253 nervous replacement,-42.01,-1017.04
23/05/2017,3289 just guarantee,-40.61,-1057.64999999999
23/05/2017,5471 stupid quiet,-160,-1217.64999999999
23/05/2017,8815 rich suggestion,-10.34,-1227.98999999999
24/05/2017,3399 general depression,-5.91,-1233.89999999999
24/05/2017,3440 upstairs hope,-47.31,-1281.20999999999
24/05/2017,4089 western twist,-14.51,-1295.71999999999
24/05/2017,86 upstairs hope,-6.7,-1302.41999999999
25/05/2017,2227 spiritual hospital,-16.66,-1319.08
25/05/2017,2479 previous sing,-40,-1359.08
25/05/2017,6695 some sea,-70,-1429.08
25/05/2017,4266 work phrase,-52.9,-1481.98
25/05/2017,7461 opposite housing,-64.61,-1546.59
26/05/2017,3308 home vegetable,-110,-1656.59
26/05/2017,5886 upstairs hope,-12.61,-1669.2
26/05/2017,7163 mother human,-25.09,-1694.28999999999
30/05/2017,7371 adult shoulder,-88.65,-1782.93999999999
30/05/2017,2247 upstairs hope,-41.47,-1824.40999999999
30/05/2017,7335 general depression,-9.59,-1833.99999999999
30/05/2017,8317 careful image,-70,-1903.99999999999
30/05/2017,2540 active function,-136.13,-2040.12999999999
30/05/2017,2136 slow work,-9.44,-2049.56999999999
30/05/2017,6131 good divide,-73.51,-2123.07999999999
30/05/2017,3742 main train,-7.14,-2130.21999999999
30/05/2017,431 kind tree,5129.21,2998.99000000001
30/05/2017,3599 sufficient stop,-27.69,2971.30000000001
30/05/2017,2965 upstairs hope,-15.45,2955.85000000001
30/05/2017,84 best idea,-22.64,2933.21000000001
31/05/2017,8675 upstairs hope,-63.31,2869.90000000001
31/05/2017,9123 female instance,-50,2819.90000000001
31/05/2017,7423 red birthday,-71.66,2748.24000000001
31/05/2017,8192 human society,-1410,1338.24000000001
01/06/2017,4033 sweet access,-15.8,1322.44000000001
01/06/2017,8127 previous sing,-40,1282.44000000001
01/06/2017,8524 life white,-11.4,1271.04000000001
01/06/2017,1136 used river,-125.55,1145.49000000001
01/06/2017,3985 female instance,-20,1125.49000000001
01/06/2017,4892 clear convert,-5.95,1119.54000000001
02/06/2017,3065 exciting yesterday,-20.64,1098.90000000001
02/06/2017,2758 available dance,-11.51,1087.39000000001
02/06/2017,7044 dry variety,-47.67,1039.72000000001
02/06/2017,2645 exciting yesterday,-78.29,961.430000000006
05/06/2017,8587 unique day,-47.4,914.030000000006
05/06/2017,9429 exciting yesterday,-8.31,905.720000000006
05/06/2017,3483 worth stand,-10.95,894.770000000006
05/06/2017,3603 exciting yesterday,-26.3,868.470000000006
05/06/2017,9530 automatic district,-160.13,708.340000000006
05/06/2017,905 firm cousin,-40,668.340000000006
05/06/2017,5547 empty major,-58.83,609.510000000006
05/06/2017,8251 firm cousin,-50,559.510000000006
05/06/2017,4136 fit owner,-113.12,446.390000000006
05/06/2017,6952 worth stand,-5.12,441.270000000006
05/06/2017,8159 unique day,-61.47,379.800000000005
05/06/2017,9939 exciting yesterday,-24.58,355.220000000006
05/06/2017,5036 exciting yesterday,-34.09,321.130000000006
06/06/2017,2259 asleep profile,-19.54,301.590000000006
06/06/2017,8344 exciting yesterday,-86.4,215.190000000006
06/06/2017,807 exciting yesterday,-20.91,194.280000000006
07/06/2017,9891 crazy car,-10,184.280000000006
07/06/2017,3978 right virus,-45.66,138.620000000006
07/06/2017,6316 frequent mirror,-8.55,130.070000000006
07/06/2017,4481 extreme emergency,-20,110.070000000006
07/06/2017,6802 according nose,-4.44,105.630000000006
07/06/2017,3390 long you,-50,55.6300000000055
07/06/2017,3197 patient report,-30.77,24.8600000000055
07/06/2017,2742 exciting yesterday,-12.59,12.2700000000055
08/06/2017,735 frequent mirror,-16.73,-4.45999999999446
08/06/2017,605 exciting yesterday,-7.45,-11.9099999999945
08/06/2017,7348 impressive equal,-1.14,-13.0499999999945
09/06/2017,7483 that brave,-4.99,-18.0399999999945
09/06/2017,2470 all skill,-58.7,-76.7399999999945
12/06/2017,8801 exciting yesterday,-24.93,-101.669999999994
12/06/2017,9512 friendly marketing,-100,-201.669999999994
12/06/2017,9527 latter swing,60,-141.669999999994
12/06/2017,2723 exciting yesterday,-5.66,-147.329999999994
12/06/2017,1118 frequent mirror,-13.8,-161.129999999995
12/06/2017,1203 kind tree,4937.92,4776.79000000001
12/06/2017,2093 firm cousin,-80,4696.79000000001
12/06/2017,9829 negative rich,-152.16,4544.63000000001
12/06/2017,2288 human society,-690,3854.63000000001
12/06/2017,1245 friendly marketing,-40,3814.63000000001
12/06/2017,9347 best idea,-78.75,3735.88000000001
13/06/2017,5626 solid check,-70,3665.88000000001
13/06/2017,5667 main train,-13.85,3652.03000000001
13/06/2017,4864 used river,-90.3,3561.73000000001
13/06/2017,8211 available dance,-5.12,3556.61000000001
14/06/2017,3673 exciting yesterday,-105.25,3451.36000000001
14/06/2017,271 exciting yesterday,-19.16,3432.20000000001
14/06/2017,7333 firm cousin,-30,3402.20000000001
14/06/2017,610 distinct national,-82.87,3319.33000000001
14/06/2017,373 worth stand,-12.08,3307.25000000001
14/06/2017,6585 unique day,-32.92,3274.33000000001
14/06/2017,1906 exciting yesterday,-61.86,3212.47000000001
15/06/2017,1863 female instance,-70,3142.47000000001
15/06/2017,6705 frequent mirror,-2.16,3140.31000000001
15/06/2017,163 additional responsibility,-60,3080.31000000001
15/06/2017,1939 master rub,-8.77,3071.54000000001
15/06/2017,2596 firm cousin,-20,3051.54000000001
16/06/2017,7786 exciting yesterday,-12.57,3038.97000000001
19/06/2017,463 solid check,-60,2978.97000000001
19/06/2017,6599 exciting yesterday,-4.8,2974.17000000001
19/06/2017,2795 impressive equal,-6.12,2968.05000000001
19/06/2017,2289 kind tree,4959.67,7927.72000000001
19/06/2017,9235 royal error,-200,7727.72000000001
19/06/2017,5107 negative rich,-670,7057.72000000001
19/06/2017,6419 best idea,-125.67,6932.05000000001
19/06/2017,3297 human society,-1290,5642.05000000001
19/06/2017,5509 kind tree,30,5672.05000000001
19/06/2017,6847 used river,-36.35,5635.70000000001
19/06/2017,902 available dance,-3.19,5632.51000000001
19/06/2017,7156 long you,-20,5612.51000000001
19/06/2017,7320 thin hand,-147.57,5464.94000000001
20/06/2017,1050 exciting yesterday,-71.66,5393.28000000001
20/06/2017,69 exciting yesterday,-15.39,5377.89000000001
20/06/2017,3917 female instance,-60,5317.89000000001
21/06/2017,8697 exciting yesterday,-12.66,5305.23000000001
21/06/2017,5035 crazy car,-40,5265.23000000001
21/06/2017,3382 capable temporary,-40,5225.23000000001
21/06/2017,5569 exciting yesterday,-9.19,5216.04000000001
22/06/2017,9205 glad poem,-22.14,5193.90000000001
22/06/2017,1319 cool piano,-58.97,5134.93000000001
22/06/2017,8512 cool piano,-26.87,5108.06000000001
22/06/2017,454 cool piano,-10.05,5098.01000000001
22/06/2017,7628 double media,-5.46,5092.55000000001
26/06/2017,5091 life white,-3.19,5089.36000000001
26/06/2017,9127 training newspaper,-47.93,5041.43000000001
26/06/2017,5229 western pension,-50,4991.43000000001
26/06/2017,824 impressive equal,-1.55,4989.88000000001
26/06/2017,8271 asleep profile,-60,4929.88000000001
26/06/2017,9889 lower judge,-22.13,4907.75000000001
26/06/2017,9533 exciting yesterday,-70.09,4837.66000000001
26/06/2017,9765 asleep library,-60,4777.66000000001
26/06/2017,7590 western pension,-50,4727.66000000001
26/06/2017,91 long you,-80,4647.66000000001
26/06/2017,9466 exciting yesterday,-11.41,4636.25000000001
26/06/2017,6631 worth goal,-70,4566.25000000001
26/06/2017,3131 latter swing,370,4936.25000000001
26/06/2017,7198 most week,-50,4886.25000000001
27/06/2017,9818 exciting yesterday,-90.91,4795.34000000001
27/06/2017,3780 best idea,-72.22,4723.12000000001
27/06/2017,460 kind tree,3234.7,7957.82000000001
27/06/2017,6804 exciting yesterday,-38.92,7918.90000000001
27/06/2017,1039 exciting yesterday,-38.53,7880.37000000001
28/06/2017,3621 exciting yesterday,-7.3,7873.07000000001
28/06/2017,1166 extreme emergency,-40,7833.07000000001
28/06/2017,8752 red birthday,-285.22,7547.85000000001
28/06/2017,8609 used river,-109.42,7438.43000000001
28/06/2017,1820 available dance,-12.95,7425.48000000001
29/06/2017,4080 exciting yesterday,-12.01,7413.47
29/06/2017,187 nearby reading,-30,7383.47
29/06/2017,5613 human society,-1580,5803.47000000001
29/06/2017,421 negative rich,-137.59,5665.88000000001
29/06/2017,8376 exciting yesterday,-11.89,5653.99000000001
29/06/2017,9626 exciting yesterday,-28.03,5625.96
29/06/2017,4710 western pension,-20,5605.96000000001
30/06/2017,6542 exciting yesterday,-46.65,5559.31000000001
30/06/2017,4888 brief equivalent,-12.77,5546.54000000001
03/07/2017,4809 exciting yesterday,-24.35,5522.19
03/07/2017,2610 firm cousin,-60,5462.19
03/07/2017,6786 dramatic insurance,-20,5442.19
03/07/2017,8103 long you,-70,5372.19
03/07/2017,9827 exciting yesterday,-19.66,5352.53
03/07/2017,4448 full estate,-26.27,5326.26
03/07/2017,1289 all skill,-36.21,5290.05
03/07/2017,3402 dramatic relief,-26.37,5263.68
03/07/2017,5667 solid check,-20,5243.68
03/07/2017,4002 exciting yesterday,-12.65,5231.03
03/07/2017,3202 time chain,-16.03,5215
03/07/2017,1718 chicken emotion,-12.09,5202.91
03/07/2017,2280 chicken emotion,-5.5,5197.41
03/07/2017,1509 firm cousin,-60,5137.41
03/07/2017,2990 exciting yesterday,-3.27,5134.14
03/07/2017,8752 negative rich,-6.66,5127.48
04/07/2017,1237 kind tree,3008.84,8136.32000000001
04/07/2017,9977 exciting yesterday,-47.92,8088.4
04/07/2017,7132 firm cousin,-50,8038.4
04/07/2017,2609 exciting yesterday,-30,8008.4
05/07/2017,3032 all skill,-10.74,7997.66
05/07/2017,3280 nearby reading,-80,7917.66
05/07/2017,9556 best idea,-50.15,7867.51
05/07/2017,7831 human society,-747.08,7120.43000000001
05/07/2017,6300 additional responsibility,-65.49,7054.94
05/07/2017,7478 used river,-44.91,7010.03000000001
06/07/2017,7484 firm cousin,-40,6970.03000000001
07/07/2017,5532 exciting yesterday,-22.82,6947.21000000001
07/07/2017,5432 select due,-5.02,6942.19000000001
07/07/2017,4580 capable temporary,-50,6892.19000000001
10/07/2017,1318 previous spend,-110,6782.19000000001
10/07/2017,4050 available dance,-4.11,6778.08000000001
10/07/2017,4265 exciting yesterday,-36.68,6741.40000000001
10/07/2017,3900 raw line,-20.49,6720.91000000001
10/07/2017,2729 kind tree,51.75,6772.66000000001
10/07/2017,7984 previous spend,-70,6702.66000000001
10/07/2017,7724 popular requirement,-35.13,6667.53000000001
10/07/2017,5376 exciting yesterday,-33.48,6634.05000000001
10/07/2017,2359 firm cousin,-50,6584.05000000001
11/07/2017,8356 capable temporary,-60,6524.05000000001
12/07/2017,816 exciting yesterday,-40.8,6483.25000000001
12/07/2017,7130 capable temporary,-70,6413.25000000001
13/07/2017,6536 kind tree,32.41,6445.66000000001
13/07/2017,8979 extreme emergency,-40,6405.66000000001
13/07/2017,5877 all skill,-10.47,6395.19000000001
13/07/2017,1103 western pension,-110,6285.19000000001
13/07/2017,3820 exciting yesterday,-46.62,6238.57000000001
14/07/2017,4539 exciting yesterday,-33.74,6204.83000000001
14/07/2017,3269 exciting yesterday,-2.36,6202.47000000001
17/07/2017,9771 female instance,-40,6162.47000000001
17/07/2017,7925 exciting yesterday,-21.69,6140.78000000001
17/07/2017,5040 additional responsibility,-39.22,6101.56000000001
17/07/2017,8751 kind tree,4980.56,11082.12
17/07/2017,6773 firm cousin,-30,11052.12
17/07/2017,4283 exciting yesterday,-62.17,10989.95
17/07/2017,8536 capable temporary,-180,10809.95
17/07/2017,1890 best idea,-91.11,10718.84
17/07/2017,4925 used river,-99.75,10619.09
18/07/2017,8552 human society,-1596.5,9022.59000000001
18/07/2017,6512 exciting yesterday,-10.85,9011.74000000001
